WWWWWWWWWWWWWWWWWWWWWWWWW
WE2EBEEBEBBEEBEEEBEBBEEEW
WEWBWEWBWEWBWEWEWEWEWEWEW
WEEEEBEBEEBBEEEBEEEEEEEMW
WEWBWEWBWEWEWGWEWEWEWBWEW
WEEEBESEEBEBEEEBEBEBEBEEW
WEWEWEWBWEWEWEWEWBWEWEWEW
WEEEEEEMEEEEEEIEEEBBEEEEW
WEEEBEEEBGEBEBEBEEBEEE1EW
WWWWWWWWWWWWWWWWWWWWWWWWW