WWWWWWWWWWWWWWWWWWWWWWWWW
WE2EBEEBEBBEEBEEEBEBBEEEW
WEWBWEWBWEWBWEWEWEWEWEWEW
WEEEEBEBEEBBEEEBEEEEEEEEW
WEWBWEWBWEWEWMWEWEWEWBWEW
WEEEEEEEEBEBEEEBEBEBEBEEW
WBWEWEWBWEWEWEWEWBWEWEWEW
WEEEEEEGEEEIEEEBEEBBEEEEW
WEEEBEEEBSEBEBEBEEBEEE1EW
WWWWWWWWWWWWWWWWWWWWWWWWW