WWWWWWWWWWWWWWWWWWWWWWWWW
WE2EBEEBEBBEEBEBEBEBBEEEW
WEEEEBEEEEEEEIBEEBEEEBEEW
WEWEWEWBWEWEWEWBWEWBWEWEW
WEEEEEEEEEEBEGEBEBEEBEEEW
WEWEWEWBWMWSWMWBWEWBWEWEW
WEEEEBEEEEBEEEEBEEEEEEEEW
WEWEWEWBWEWEWEWBWEWBWEWEW
WEEEGEBEIEEBEEEEBEEEEEE1W
WWWWWWWWWWWWWWWWWWWWWWWWW